%%%%%%%
%Go  P%
% %%% %
% .%  %
%%   %%
%. %%%%
%%%%%%%
